wwwwwwwwwww
w         d
w ppp ppp w
w ppp ppp w
w ppp ppp w
w         w
w ppp ppp w
w ppp ppp w
w ppp ppp w
wl        w
wwwwwwwwwww