wwwwwdwwwww
w         w
w wwwwwwwww
w ww      w
w    hh   w
wl   hh   d
w    hh   w
w ww      w
w wwwwwwwww
w         w
wwwwwwwwwww