wwwwwwwwwww
w         w
w         w
w         w
w         w
w    i    w
w         w
w         w
w         w
w         s
wwwwwwwwwww