wwwwwwwwwww
c w   w   w
w w w w w w
w w w w w w
w w w w w w
w wcwcwcw w
w w w w w w
w w w w w w
w w w w w w
w   w   w w
wwwwwwwwwdw