wwwwwwwwwww
w         w
w   whw   w
w         w
w   whw   w
d         d
w   whw   w
w         w
w   whw   w
w         w
wwwwwwwwwww