wwwwwwwwwww
w         w
w pppcppp w
w ppp ppp w
w ppXXXpp w
w c XXX c w
w ppXXXpp w
w ppp ppp w
w pppcppp w
w    l    w
wwwwwdwwwww