wwwwwdwwwww
w     w   w
w  w  w   w
w  w      w
w  w      w
d  wwwwwwlw
w  w      w
w  w      w
w  w  w   w
w     w   w
wwwwwwwwwww