wwwwwdwwwww
w   w w   w
w w w w w w
w w w w w w
w w w w w w
w w  B  w w
w wwwwwww w
w         w
wSSSSSSSSSw
wSSSSSSSSSw
wwwwwdwwwww