wwwwwswwwww
www     www
wwwww wwwww
w www www w
w www www w
w        lw
w www www w
w www www w
wwwww wwwww
d       www
wwwwwwwwwww