wwwwwdwwwww
w   w     w
w ggg ggg w
w ggg ggg w
w ggggggg w
d ggggggg w
w ggggggg w
w ggg ggg w
w ggg ggg w
w    c    w
wwwwwwwwwww