wwwwwcwwwww
wwww   wwww
wwww   wwww
wl        w
w ww   ww w
w ww   ww w
w         w
w ww   ww w
w ww   ww w
w         w
wwwwwdwwwww