wwwwwwwwwww
w         w
w wwwwwww w
w w       w
w w       w
d w       w
w w       w
w w       d
w wwwwwwwww
w       clw
wwwwwwwwwww