wwwwwwwwwww
w        iw
w wwwwwwwww
w w       w
w w wwwww w
w w w     w
w w w wwwww
w w w w   w
w w w w w w
w   w   w w
wwwwwwwwwsw