wwwwwwwwwdw
ww        w
w   www   w
w   www   w
w wwwwwww w
w wwwwwww w
w wwwwwww w
w   www   w
w   www   w
w        ww
wdwwwwwwwww